wwwwwwwwwwwwwwwwwwww
w..................w
w..w...............w
w..w...............w
w..w.......wwwww...w
w..w...............w
w..................w
w.......s..........w
w..................w
w...........w......w
w..................w
w..................w
w......w...........w
w..................w
wwwwwwwwwwwwwwwwwwww